########
#S##...#
#.##.###
#.....D#
########